1111111
1C0U001
1000001
1P000E1
1111111
