1111111
1C10001
1110001
1P000E1
1111111